1111111
1P00H01
1000101
1H0C0H1
1010101
1E00001
1111111
