1111111
1P00001
10C1C01
1010101
10C0C01
1E00001
1111111
