111111111
1P00000C1
101111101
100000001
10C111C01
101000101
1E00000C1
111111111
