11111
1PXA1
10#01
1C0E1
11111
