111111
1P0011
100E11
1C0HC1
111111