111111
1P0011
100E11
1C01C1
111111